| | | | | | |
| S _ _ _ L |
| _ | | _ _ |
| _ _ | _ _ |
| _ _ | _ _ |
| _ L | E _ |
| | | | | | |
