| | | | | | | | | |
| _ S _ _ | | | | |
| _ _ _ _ _ _ _ L |
| _ _ _ | _ | _ | |
| _ _ _ | _ | _ | |
| _ _ _ | _ | _ | |
| _ L _ | _ | _ | |
| _ | | | _ | _ | |
| _ | _ _ L | _ | |
| _ | _ | | | _ | |
| _ | _ | _ _ _ _ |
| _ | _ | _ _ _ _ |
| _ | _ | _ _ _ _ |
| _ | _ | _ _ _ _ |
| _ | _ | _ _ _ _ |
| _ | _ | _ E _ _ |
| L | L | _ _ _ _ |
| | | | | | | | | |
